11111111
1P0000C1
1000C0C1
1000CC01
100C0001
10C0C0E1
100C00C1
11111111
